50 50
121 0 0 121 10 10 121 0 0 121 10 10 121 0 121 0 231 1121 1121 1121 1121 1121 1121 1121 1121 1121 1121 1121 1121 1121 41 1121 1121 131 1021 0 0 2021 1121 131 1121 131 1121 131 41 1121 1021 0 0 121 
121 0 0 121 10 10 121 0 0 121 10 10 121 0 121 0 121 10 10 0 0 0 0 0 0 0 0 0 10 10 121 10 10 121 121 0 0 121 0 121 0 121 0 121 121 10 3021 1021 0 121 
121 0 0 121 10 10 121 0 0 121 10 10 121 0 121 0 121 10 10 0 0 0 0 0 0 0 0 0 10 10 121 10 10 121 121 0 0 121 0 121 0 121 0 121 121 10 10 121 0 121 
121 0 0 121 10 10 121 0 0 121 10 10 121 0 121 0 231 1121 1121 1121 1121 1121 1121 1121 1121 1121 1121 1121 1121 1121 31 10 10 121 3021 1021 2021 21 0 121 0 121 0 121 121 10 2021 21 0 121 
121 0 0 121 10 10 121 0 0 121 10 10 121 0 121 0 121 0 0 10 10 0 0 0 0 0 10 10 0 0 231 1121 1121 21 0 3021 21 0 0 11 0 11 0 11 3021 1121 21 0 0 121 
121 0 0 121 10 10 121 0 0 121 10 10 121 0 121 0 121 0 0 10 10 0 0 0 0 0 10 10 0 0 121 0 0 0 0 0 0 0 0 0 0 0 0 0 0 0 0 0 0 121 
231 1121 1121 331 1121 1121 331 1121 131 331 1121 1121 331 1121 331 1121 41 1121 1121 1121 1121 1121 1121 1121 1121 1121 1121 1121 1121 1121 41 1121 1121 1121 1121 1121 1121 1121 1121 1121 1121 1121 1121 1121 1121 1121 1121 1121 1121 31 
121 0 0 0 0 0 0 0 121 0 0 0 0 0 0 0 121 0 0 0 0 10 10 0 10 10 0 0 0 0 121 0 0 10 10 0 0 10 10 0 0 10 10 0 0 10 10 0 0 121 
121 0 2021 1121 1121 1121 1121 1121 41 1121 1121 1121 1121 1121 1021 0 121 0 0 0 0 10 10 0 10 10 0 0 0 0 121 0 0 10 10 0 0 10 10 0 0 10 10 0 0 10 10 0 0 121 
121 0 121 10 10 10 10 10 121 10 10 10 10 10 121 0 231 1121 1121 1121 1121 1121 1121 1121 1121 1121 1121 1121 1121 1121 41 1121 1121 1121 1121 1121 1121 1121 1121 1121 131 1121 1121 1121 1121 1121 1121 1121 1121 31 
121 0 121 10 2021 1121 1121 1121 41 1121 1121 1121 1021 10 121 0 121 0 0 0 0 10 10 10 10 0 0 0 0 0 121 0 0 0 0 0 0 0 0 0 121 0 0 0 0 0 0 0 0 121 
121 0 121 10 121 0 0 0 121 0 0 0 121 10 121 0 121 0 0 0 0 10 10 10 10 0 0 0 0 0 121 0 0 0 0 0 0 0 0 0 121 0 0 0 0 0 0 0 0 121 
121 0 121 10 121 0 2021 1121 41 1121 1021 0 121 10 121 0 231 1121 1121 1121 1121 1121 1121 1121 1121 1121 1121 1121 1121 1121 41 1121 1121 131 1121 1121 1121 1121 1121 1121 31 1121 1121 1121 1121 1121 131 1121 1121 31 
121 0 121 10 121 0 121 0 121 0 121 0 121 10 121 0 121 0 0 10 10 0 0 0 0 10 10 0 0 0 121 0 0 121 0 0 0 0 0 0 121 0 0 0 0 0 121 0 0 121 
121 1121 41 1121 41 1121 41 1121 41 1121 41 1121 41 1121 41 1121 41 1121 1121 1121 1121 1121 1121 1121 1121 1121 1121 1121 1121 1121 31 0 0 121 0 0 0 0 0 0 121 0 0 0 0 0 121 0 0 121 
121 0 121 10 121 0 121 0 121 0 121 0 121 10 121 0 121 10 10 0 0 0 0 0 0 0 0 10 10 10 121 10 10 231 1121 1121 1121 1121 1121 1121 41 1121 1121 1121 1121 1121 31 10 10 121 
121 0 121 10 121 0 3021 1121 41 1121 21 0 121 10 121 0 231 1121 1121 1121 1121 1121 1021 10 2021 1121 1121 1121 1121 1121 31 10 10 121 0 0 0 0 0 0 121 0 0 0 0 0 121 10 10 121 
121 0 121 10 121 0 0 0 121 0 0 0 121 10 121 0 121 10 10 10 10 10 121 10 121 10 10 10 10 10 121 10 10 121 0 0 0 0 0 0 121 0 0 0 0 0 121 10 10 121 
121 0 121 10 3021 1121 1121 1121 41 1121 1121 1121 21 10 121 0 231 1121 1121 1121 1021 10 121 10 121 10 2021 1121 1121 1121 31 10 10 231 1121 1121 1121 1121 1121 1121 41 1121 1121 1121 1121 1121 31 10 10 121 
121 0 121 10 10 10 10 10 121 10 10 10 10 10 121 0 121 10 10 10 121 10 121 10 121 10 121 10 10 10 121 10 10 121 0 0 0 0 0 0 121 0 0 0 0 0 121 10 10 121 
121 0 3021 1121 1121 1121 1121 1121 41 1121 1121 1121 1121 1121 21 0 231 1121 1021 10 121 10 121 10 121 10 121 10 2021 1121 31 0 0 231 1121 1121 1121 1121 1121 1121 41 1121 1121 1121 1121 1121 31 0 0 121 
121 0 0 0 0 0 0 0 121 0 0 0 0 0 0 0 121 10 121 10 121 10 121 10 121 30 121 10 121 10 121 0 0 121 0 0 0 0 0 0 121 0 0 0 0 0 121 0 0 121 
3021 1121 1121 1121 1121 1121 1121 1121 331 1121 1121 1121 131 1121 1121 1121 331 131 331 1121 331 131 331 1121 331 131 331 1121 331 131 331 1121 1121 41 1121 1121 131 1121 131 1121 331 131 1121 1121 131 1121 331 1121 1121 31 
0 0 0 0 0 0 0 0 0 0 0 0 121 0 10 10 10 121 10 10 10 121 10 10 10 121 10 10 10 121 10 10 10 121 0 0 121 0 121 0 0 121 10 10 121 0 0 121 0 121 
0 0 0 0 0 0 0 0 0 0 0 0 121 0 10 10 10 121 10 10 10 121 10 10 2021 331 1021 10 10 121 10 10 10 121 0 0 121 0 121 0 0 121 10 10 121 0 0 121 0 121 
1121 1121 1121 1121 1121 1121 1121 131 1121 1121 1121 1121 41 1121 1121 1121 1121 41 1121 1121 1121 41 1121 1121 31 20 231 1121 1121 41 1121 1121 1121 41 0 0 121 0 121 0 0 121 10 10 121 0 0 121 0 121 
0 0 0 0 0 0 0 121 0 0 0 0 121 0 10 10 10 121 10 10 10 121 10 10 3021 131 21 10 10 121 10 10 10 121 0 0 121 0 121 0 0 121 10 10 121 0 0 121 0 121 
0 0 0 0 0 0 0 121 0 0 0 0 121 0 10 10 10 121 10 10 10 121 10 10 10 121 10 10 10 121 10 10 10 121 0 0 121 0 121 0 0 121 10 10 121 0 0 121 0 121 
1121 131 1121 1121 1121 131 1121 331 1121 131 1121 41 331 1121 131 1121 1121 41 1121 1121 131 331 1121 131 1121 41 1121 1121 1121 331 1121 1121 1121 31 0 0 121 0 231 1121 1121 41 1121 1121 41 1121 1121 41 1121 31 
0 121 0 0 0 121 0 0 0 121 10 121 0 10 121 10 0 121 10 10 121 10 10 121 10 121 10 10 10 10 10 10 10 121 0 0 121 0 121 10 10 121 0 0 121 10 10 121 0 121 
1121 21 0 2021 1121 21 0 2021 1121 21 10 121 0 10 121 10 0 121 10 10 121 10 10 121 10 121 10 10 10 10 10 10 10 121 0 0 121 0 121 10 10 121 0 0 121 10 10 121 0 121 
0 0 0 121 0 0 0 121 10 10 10 121 0 10 121 10 0 121 10 10 121 10 10 121 10 3021 1121 1121 1121 1121 1121 1121 1121 331 1121 1121 21 0 121 10 10 121 0 0 121 10 10 121 0 121 
0 2021 1121 21 0 2021 1121 21 10 2021 1121 31 0 10 121 10 0 121 10 10 121 10 10 121 10 10 10 10 10 10 10 10 10 10 0 0 0 0 121 10 10 121 0 0 121 10 10 121 0 121 
0 121 0 0 0 121 10 10 10 121 0 121 0 10 121 10 0 121 10 10 121 10 10 121 10 10 10 10 10 10 10 10 10 10 0 0 0 0 121 10 10 121 0 0 121 10 10 121 0 121 
1121 21 0 2021 1121 21 10 2021 1121 21 0 121 0 10 121 10 0 121 10 10 3021 1121 1121 41 1121 1121 1121 1121 1121 1121 131 1121 131 1121 131 1121 131 1121 41 1121 131 331 131 1121 331 131 1121 131 1121 31 
0 0 0 121 10 10 10 121 0 0 0 121 0 10 121 10 0 121 0 0 0 0 0 121 0 0 0 0 0 0 121 0 121 10 121 0 121 10 121 0 121 10 121 0 0 121 10 121 0 121 
0 2021 1121 21 10 2021 1121 21 0 2021 1121 31 0 10 121 10 0 231 1121 1121 1121 1121 1121 331 1121 131 1121 1021 0 0 121 0 121 10 121 0 121 10 121 0 121 10 121 0 0 121 10 121 0 121 
0 121 10 10 10 121 0 0 0 121 0 121 0 10 121 10 0 121 10 10 10 10 0 0 0 121 10 121 0 0 121 0 121 10 121 0 121 10 121 0 121 10 121 0 0 121 10 121 0 121 
2021 331 1121 131 1121 331 1121 1121 1121 41 1121 41 1121 1121 331 1121 1121 31 10 2021 1121 131 1121 131 1121 31 10 121 0 0 121 0 121 10 121 0 121 10 121 0 121 10 121 0 0 121 10 121 0 121 
121 0 0 121 0 0 0 0 0 121 10 121 0 0 0 0 0 121 10 121 10 121 10 121 0 121 10 121 0 0 121 0 121 10 121 0 121 10 121 0 121 10 121 0 0 121 10 121 0 121 
121 0 0 231 1121 1121 1121 1021 0 121 10 231 1121 1021 0 2021 1121 31 10 121 10 121 10 121 0 121 10 121 0 0 121 0 121 10 121 0 121 10 121 0 121 10 121 0 0 121 10 121 0 121 
121 0 0 121 10 10 10 121 0 121 10 121 0 3021 131 21 0 121 0 121 0 121 0 121 0 121 10 121 0 0 121 0 121 10 121 0 121 10 121 0 121 10 121 0 0 121 10 121 0 121 
121 0 0 121 10 2021 1121 41 1121 21 10 121 0 0 121 0 0 121 0 121 0 121 0 121 10 121 10 121 0 0 121 0 121 10 121 0 121 10 121 0 121 10 3021 1121 1121 21 10 121 0 121 
121 0 0 121 10 121 0 121 10 10 10 121 0 2021 331 1021 0 121 0 121 0 121 0 121 10 121 10 3021 1121 131 21 0 121 10 121 0 121 10 121 0 121 0 0 0 0 0 0 121 0 121 
121 0 0 121 10 121 0 3021 1121 1121 1121 41 1121 21 0 3021 1121 31 0 231 1121 331 1121 21 10 121 10 10 10 121 0 0 121 10 121 0 121 10 121 0 3021 1121 1121 1121 1121 1121 1121 21 0 121 
121 0 0 121 10 121 0 0 0 0 0 121 0 0 0 0 0 121 0 121 10 10 10 10 10 121 10 10 10 121 0 0 121 10 121 0 121 10 121 0 0 0 0 0 0 0 0 0 0 121 
231 1121 1121 331 1121 331 1121 1121 1121 1121 1121 331 1121 1121 1121 1121 1121 331 1121 41 1121 1121 1121 1121 1121 331 1121 1121 1121 331 1121 1121 331 1121 331 1121 331 1121 41 1121 1121 1121 1121 1121 1121 1121 1121 1121 1121 31 
121 0 0 10 10 0 0 10 10 0 0 10 10 0 0 10 10 0 0 121 0 0 10 10 0 0 10 10 0 0 10 10 0 0 10 10 0 0 121 0 0 10 10 0 0 10 10 0 0 121 
121 0 0 10 10 0 0 10 10 0 0 10 10 0 0 10 10 0 0 121 0 0 10 10 0 0 10 10 0 0 10 10 0 0 10 10 0 0 121 0 0 10 10 0 0 10 10 0 0 121 
3021 1121 1121 1121 1121 1121 1121 1121 1121 1121 1121 1121 1121 1121 1121 1121 1121 1121 1121 331 1121 1121 1121 1121 1121 1121 1121 1121 1121 1121 1121 1121 1121 1121 1121 1121 1121 1121 331 1121 1121 1121 1121 1121 1121 1121 1121 1121 1121 21 
